Alunos definidos em algumas palavras:

Anthony: Sinuca, Zuero e estiloso

Bea: introvertida, legal e estudiosa

cauan: Mugen

Davi: Bigode, Abu e PURO DRIP

Danilo: Boxer, fundão e Sigma

Everton: Respira codigos, Curso ds 3 vezes e SHAPE

Eduardo: boina, BOMBAS e cafe

Giovana: Baixinha, Vôlei e RPG

Guilherme: turma da frente e nunca falta

Gabriel: 👍

Giulia: Altos estudos, ri de tudo e extro/introvertida

Hihi: Fan de vôlei, ri d etudo tbm e mãe do ds1º

Juliane:  🌿, Ri de tudo tbm e vem em todas as aulas (confia)

Jose: Bola bola, MBvôlei/Futebol e faz piada com todos

Joao victor: black man, esperto e melhor levantador

joao: sabedoria desbalanceada, amigo do zé e itariri man

Mauricio: mauricio, anthony -2.0 e GamerMugen

Matheus pacifico: pacifistas, inimigoantisocial e ama sua mulher

Murilo: Mulher do samuel, lindo e filho do arcanjo

Nicolas: Mulher de todos, loro e EletricidadeMan

Otavio: descendente do everton, agatafanclube e melhor ponta (da sala)

Pricila: ama slides, altas criticas e odeia fid

Pedro Augusto: alto, engraçado e profissional vôlei

Pedro menor: Baixo, otimo libero e inimigo do tenis

Raul mazonni: alto, versatil e man poeta

Raul Galdino: mel, otimo em tudo no vôlei e cantor/dançarino

Rafael: Cursa DS/MDI, tropa da frente e fantasma da sala

Samuel: Lorinha, Peitos e Tenta jogar volêi

Wenvel: Wenvel 👍